{"map" :   [[4,2,2,2,2,2,2,2,2,2,2,2,2,5,4,2,2,2,2,2,2,2,2,2,2,2,2,5],
            [3,-1,1,1,1,1,1,1,1,1,1,1,1,3,3,1,1,1,1,1,1,1,1,1,1,1,-1,3],
            [3,1,4,2,2,5,1,4,2,2,2,5,1,3,3,1,4,2,2,2,5,1,4,2,2,5,1,3],
            [3,1,3,0,0,3,1,3,0,0,0,3,1,3,3,1,3,0,0,0,3,1,3,0,0,3,1,3],
            [3,1,7,2,2,6,1,7,2,2,2,6,1,7,6,1,7,2,2,2,6,1,7,2,2,6,1,3],
            [3,1,1,1,1,1,1,1,1,1,1,1,1,1,1,1,1,1,1,1,1,1,1,1,1,1,1,3],
            [3,1,4,2,2,5,1,4,5,1,4,2,2,2,2,2,2,2,1,4,5,1,4,2,2,5,1,3],
            [3,1,7,2,2,6,1,3,3,1,7,2,2,5,4,2,2,2,1,3,3,1,7,2,2,6,1,3],
            [3,1,1,1,1,1,1,3,3,1,1,1,1,3,3,1,1,1,1,3,3,1,1,1,1,1,1,3],
            [7,2,2,2,2,5,1,3,7,2,2,5,1,3,3,1,4,2,2,6,3,1,4,2,2,2,2,6],
            [0,0,0,0,0,3,1,3,4,2,2,6,1,3,3,1,7,2,2,5,3,1,3,0,0,0,0,0],
            [0,0,0,0,0,3,1,3,3,1,1,1,1,3,3,1,1,1,1,3,3,1,3,0,0,0,0,0],
            [0,0,0,0,0,3,1,3,3,1,0,0,2,6,7,2,0,0,1,3,3,1,3,0,0,0,0,0],
            [2,2,2,2,2,6,1,7,6,1,3,0,0,0,0,0,0,3,1,7,6,1,7,2,2,2,2,2],
            [1,1,1,1,1,1,1,1,1,1,3,-2,0,-2,0,-2,0,3,1,1,1,1,1,1,1,1,1,1],
            [2,2,2,2,2,5,1,4,5,1,3,0,0,0,0,0,-2,3,1,4,5,1,4,2,2,2,2,2],
            [0,0,0,0,0,3,1,3,3,1,7,2,2,5,4,2,2,6,1,3,3,1,3,0,0,0,0,0],
            [0,0,0,0,0,3,1,3,3,1,1,1,1,3,3,1,1,1,1,3,3,1,3,0,0,0,0,0],
            [0,0,0,0,0,3,1,3,3,1,4,2,2,6,7,2,2,5,1,3,3,1,3,0,0,0,0,0],
            [4,2,2,2,2,6,1,7,6,1,7,2,2,5,4,2,2,6,1,7,6,1,7,2,2,2,2,5],
            [3,1,1,1,1,1,1,1,1,1,1,1,1,3,3,1,1,1,1,1,1,1,1,1,1,1,1,3],
            [3,1,4,2,2,5,1,4,2,2,2,5,1,3,3,1,4,2,2,2,5,1,4,2,2,5,1,3],
            [3,1,7,2,6,3,1,7,2,2,2,6,1,3,3,1,7,2,2,2,6,1,3,4,2,6,1,3],
            [3,1,1,1,3,3,1,1,1,1,1,1,1,3,3,1,1,1,1,1,1,1,3,3,1,1,1,3],
            [3,4,5,1,3,3,1,4,5,1,4,2,2,6,7,2,2,5,1,4,5,1,3,3,1,4,5,3],
            [3,7,6,1,7,6,1,3,3,1,7,2,2,5,4,2,2,6,1,3,3,1,7,6,1,7,6,3],
            [3,1,1,1,1,1,1,3,3,1,1,1,1,3,3,1,1,1,1,3,3,1,1,1,1,1,1,3],
            [3,1,4,2,2,2,2,6,7,2,2,5,1,3,3,1,4,2,2,6,7,2,2,2,2,5,1,3],
            [3,1,7,2,2,2,2,2,2,2,2,6,1,7,6,1,7,2,2,2,2,2,2,2,2,6,1,3],
            [3,-1,1,1,1,1,1,1,1,1,1,1,1,1,1,1,1,1,1,1,1,1,1,1,1,1,-1,3],
            [7,2,2,2,2,2,2,2,2,2,2,2,2,2,2,2,2,2,2,2,2,2,2,2,2,2,2,6]]
}
